arab: Arab

armenian: Az örmény

avestan: Az Avestan

balinese: A balinéz

bamum: Bamum

bashkir: Bashkir

bassa-vah: Bassa

batak: Batak

belarusian: Fehérorosz

bengali: Bengáli

bopomofo: Zhuyin. Bopomofo

brahmi: Brahmi

buginese: Buginai

buhid: Buhid

bulgarian: A bolgár

carian: A karian

caucasian-albanian: Kaukázusi albán

chakma: Chakma

cham: Chamsky

cherokee: Cherokee szlappikus

chinese: Kínai pinyin

coptic: Koptos

cypriot-syllabary: Ciprusi szlappikus

cyrillic: Cirill

czech: Cseh

deseret: Deseretian

devanagari: Devanagari

elbasan: Elbasan

english: Angol

esperanto: Eszperantó

ethiopic: Etiópiai szláv nyelvű

french: Francia

georgian: Grúz

german: Német

glagolitic: Glagolitikus

gothic: Gótikus

grantha: Grantha

greek: Görög

gujarati: Gujarati

gurmukhi: Gurmukhi

hangul: Koreai Hangeul

hanunoo: Hanunoo

hebrew: Héber

hungarian: Magyar

imperial-aramaic: Arámi császári

international-phonetic-alphabet: Nemzetközi fonetikus

italian: Olasz

japanese-hiragana: Japán Hiragana

japanese-katakana: Japán katakana

javanese: Jáva

kaithi: Kaithi

kannada: Kannada

kayah-li: Kayah

kazakh: Kazah betű

kharoshthi: Kharoshti

khmer: Khmer

khojki: Codic

khudawadi: Khudabadi

lao: Laoszi

latin: Latin

lepcha: A penész

limbu: Alphabet Head

linear-b-Syllabary: Lineáris B betű

lisu: Betűs

lycian: Lyciás

lydian: Lidia

mahajani: Mahajani

malayalam: Malayalam

mandaic: Mandaean

manichaean: Manicheae

meetei-mayek: Matej-mahek

mende-kikakui: Kikakui Mende számára

meroitic-cursive: Meroitikus dőlt betű

modi: Modi

mongolian: Mongol régi

mro: Mro

myanmar: Burmai

nabataean: Nabateai

new-tai-lue: Tayla új

nko: Nko

ogham: Ogham

ol-chiki: Olchiki

old-italic: Etruszk

old-north-arabian: Arab északi régi

old-permic: Permian ősi

old-persian: Perzsa ókori cuneiform

old-south-arabian: Arabiai déli

old-turkic: Türkic ősrákos

oriya: Oriya

osmanya: Török

pahawh-hmong: Pachau

pahlavi: Pahlavi

palmyrene: Palmyra

pau-cin-hau: Pau Ching Hau

phags-pa: Pagba-lámai

phoenician: Föníciai

polish: Lengyel

pollard: Pollard

rejang: Rejan

runic: Germán rózsás

russian: Orosz betű

samaritan: Szamaritánus

saurashtra: Saurastra

sharada: Charade

shavian: Bernard Show

siddham: Siddhamataka

sinhala: Szingaléz

sora-sompeng: Sorang Sompeng

spanish: Spanyol

sundanese: Szundán

syloti-nagri: Sylheti nagari

syriac: Szíriai

tagalog: Tagalog abc

tagbanwa: Tagbanwa

tai-le: Tai Lai

tai-tham: Tai tham

tai-viet: Tai megnyeri az

takri: Takri

tamil: Tamil

tatar: Tatár

telugu: Telugu

thaana: Tana

thai: Thai

tibetan: Tibeti

tifinagh: Typhanag

tirhuta: Tyrhuta

turkish: Török

ugaritic: Ugaritikus

ukrainian: Ukrán

unified-canadian-aboriginal-syllabics: Kanadai aboriginális szlappikus

vai: Vai szótagos

varang-kshiti: Varang kshiti

yi-syllables: És a szllabi ábéc nyelvét
