arab: Arabic

armenian: Armenian

avestan: Avestan 

balinese: Balinese

bamum: Bamum

bashkir: Bashkir

bassa-vah: Bassa-vah 

batak: Batak 

belarusian: Belarusian 

bengali: Bengali 

bopomofo: Bopomofo. Zhuyin

brahmi: Brahmi

buginese: Buginese

buhid: Buhid 

bulgarian: Bulgarian 

carian: Carian 

caucasian-albanian: Caucasian Albanian

chakma: Chakma

cham: Cham

cherokee: Cherokee

chinese: Chinese Pinyin

coptic: Coptic

cypriot-syllabary: Cypriot syllabary

cyrillic: Cyrillic

czech: Czech

deseret: Deseret

devanagari: Devanagari

elbasan: Elbasan

english: English 

esperanto: Esperanto

ethiopic: Ethiopic Ge ªez

french: French

georgian: Georgian

german: German

glagolitic: Glagolitic

gothic: Gothic

grantha: Grantha

greek: Greek

gujarati: Gujarati

gurmukhi: Gurmukhi

hangul: Hangul

hanunoo: Hanunoo

hebrew: Hebrew

hungarian: Hungarian

imperial-aramaic: Imperial Aramaic

international-phonetic-alphabet: International Phonetic

italian: Italian

japanese-hiragana: Japanese Hiragana

japanese-katakana: Japanese Katakana

javanese: Javanese

kaithi: Kaithi

kannada: Kannada

kayah-li: Kayah Li

kazakh: Kazakh

kharoshthi: Kharoshthi

khmer: Khmer

khojki: Khojki

khudawadi: Khudawadi

lao: Lao

latin: Latin

lepcha: Lepcha

limbu: Limbu

linear-b-Syllabary: Linear B syllabary

lisu: Lisu

lycian: Lycian

lydian: Lydian

nabataean: Nabataean

mahajani: Mahajani

malayalam: Malayalam

mandaic: Mandaic

manichaean: Manichaean

meetei-mayek: Meetei Mayek

mende-kikakui: Mende Kikakui

meroitic-cursive: Meroitic Cursive

modi: Modi

mongolian: Mongolian

mro: Mro

myanmar: Myanmar

new-tai-lue: New Tai Lue

nko: Nko

ogham: Ogham

ol-chiki: Ol Chiki

old-italic: Old Italic Etruscan

old-north-arabian: Old North Arabian

old-permic: Old Permic

old-persian: Old Persian

old-south-arabian: Old South Arabian

old-turkic: Old Turkic Runic

oriya: Oriya

osmanya: Osmanya

pahawh-hmong: Pahawh Hmong

pahlavi: Pahlavi

palmyrene: Palmyrene

pau-cin-hau: Pau Cin Hau

phags-pa: Phags-pa

phoenician: Phoenician

polish: Polish

pollard: Pollard

rejang: Rejang

runic: Runic

russian: Russian

samaritan: Samaritan

saurashtra: Saurashtra

sharada: Sharada

shavian: Shavian

siddham: Siddham

sinhala: Sinhala

sora-sompeng: Sora Sompeng

spanish: Spanish

sundanese: Sundanese

syloti-nagri: Syloti Nagri

syriac: Syriac

tagalog: Tagalog

tagbanwa: Tagbanwa

tai-le: Tai Le

tai-tham: Tai Tham

tai-viet: Tai Viet

takri: Takri

tamil: Tamil

tatar: Tatar

telugu: Telugu

thaana: Thaana

thai: Thai

tibetan: Tibetan

tifinagh: Tifinagh

tirhuta: Tirhuta

turkish: Turkish

ugaritic: Ugaritic

ukrainian: Ukrainian

unified-canadian-aboriginal-syllabics: Unified Canadian Aboriginal Syllabics

vai: Vai

varang-kshiti: Varang Kshiti

yi-syllables: Yi Syllables