properties: NieruchomoÅ›ci
hide: ChowaÄ‡
show: DowodziÄ‡
up: Na gÃ³rze
range: Zakres
loading: ÅadujÄ™ ...
count: Liczba znakÃ³w
sort-order: W porzÄ…dku
sort-block: WedÅ‚ug kategorii
copy-clipboard: SkopiowaÄ‡ do schowka
help-range: Kliknij, aby podÅ›wietliÄ‡
more: WiÄ™cej
prev: Prev.
next: Dalej.
separate-page: Otwarty na oddzielnej stronie
share-link: Podziel siÄ™ z przyjaciÃ³Å‚mi
recent: Ostatnio uÅ¼ywane
recent-text: ChociaÅ¼ pusta. ZakÅ‚adka ta pokaÅ¼e posledenie skopiowane znaki.
read-more: wiÄ™cej
read-less: UkryÄ‡
madeby: NiezbÄ™dny w
keepupdates: UwaÅ¼aj na aktualizacje na portalach spoÅ‚ecznoÅ›ciowych
hint: Wybierz Å¼Ä…dany znak i skopiuj

copied: Skopiowane!
see_also: Zobacz teÅ¼
page_content_menu: TreÅ›Ä‡
homepage: Strona gÅ‚Ã³wna
cookie-message: Ta strona uÅ¼ywa ğŸªplikÃ³w cookie, aby zapewniÄ‡ najlepszÄ… jakoÅ›Ä‡.
accept: ZaakceptowaÄ‡
empty-cell: Pusta komÃ³rka
block-description: Opis
more-information: Czytaj wiÄ™cej
back: Z powrotem
widget-keyboard-title: Schowek symboli
widget-keyboard-placeholder: Tutaj sÄ… wszystkie symbole, ktÃ³re kopiujesz âœ¨

[mobile]
to-full: PrzejdÅº do peÅ‚nej wersji
to-mobile: PrzejdÅº do wersji mobilnej

[edit]: ZmianÄ™
save: ZachowaÄ‡
submit: WysÅ‚aÄ‡
undo: AnulowaÄ‡
send-changes: Zmiana zostanie wysÅ‚any do strony deweloperÃ³w. Czy jesteÅ› pewien?
thanks: DziÄ™kujÄ™!
