hide: éšè—
show: å±•ç¤º
up: å›é¡¶éƒ¨
range: èŒƒå›´
loading: æ­£åœ¨è½½å…¥ï¼Œè¯·ç¨ç­‰
count: å­—ç¬¦æ€»æ•°
sort-order: æŒ‰é¡ºåº
sort-block: æŒ‰å­—ç¬¦èŒƒå›´åˆ†æ®µ
copy-clipboard: å¤åˆ¶åˆ°å‰ªè´´æ¿
help-range: ç‚¹å‡»æ˜¾ç¤ºå­—ç¬¦èŒƒå›´
more: æ›´å¤š
prev: å‘å‰
next: å‘å
separate-page: æ–°å¼€é¡µé¢
share-link: åˆ†äº«
# @todo recent
# @todo recent-text
read-more: é˜…è¯»æ›´å¤š
read-less: éšè—

copied: å·²å¤åˆ¶ï¼
see_also: å‚è§
homepage: ä¸»é 
cookie-message: æœ¬ç½‘ç«™ä½¿ç”¨ ğŸªcookie æ¥ç¡®ä¿æ‚¨è·å¾—æœ€ä½³ä½“éªŒã€‚
accept: æ¥å—
empty-cell: ç©ºå•å…ƒæ ¼
page_content_menu: ç›®å½•

[mobile]
to-full: æŸ¥çœ‹å®Œæ•´ç‰ˆ
# @todo to-mobile

[edit]: ç¼–è¾‘
save: ä¿å­˜
submit: æäº¤
undo: æ’¤æ¶ˆ
send-changes: æ‚¨æ‰€åšçš„æ›´æ”¹å°†è¢«å‘é€åˆ°è¯¥ç½‘ç«™çš„å¼€å‘ã€‚ä½ ç¡®å®šå—ï¼Ÿ
thanks: è°¢è°¢
