arab: Arabe

armenian: Armênio

avestan: Avestan

balinese: Balinês

bamum: Bamum

bashkir: Bashkir

bassa-vah: Bassa-vah

batak: Batak

belarusian: Bielorrusso

bengali: Bengali

bopomofo: Bopomofo. Zhuyin

brahmi: Brahmi

buginese: Buginês

buhid: Buhid

bulgarian: Búlgaro

carian: Cariano

caucasian-albanian: Albanês caucasiano

chakma: Chakma

cham: Cham

cherokee: Cherokee

chinese: Chinês pinyin

coptic: Copta

cypriot-syllabary: Cipriota silabário

cyrillic: Cirílico

czech: Tcheco

deseret: Deseret

devanagari: Devanagari

elbasan: Elbasan

english: Ingles

esperanto: Esperanto

ethiopic: Etíope Ge'ez

french: Francês

georgian: Georgiano

german: Alemão

glagolitic: Glagolítico

gothic: Gótico

grantha: Grantha

greek: Grego

gujarati: Gujarati

gurmukhi: Gurmukhi

hangul: Hangul

hanunoo: Hanunoo

hebrew: Hebraico

hungarian: Húngaro

imperial-aramaic: Aramaico imperial

international-phonetic-alphabet: Fonético internacional

italian: Italiano

japanese-hiragana: Hiragana japonês

japanese-katakana: Katakana japonês

javanese: Javanês

kaithi: Kaithi

kannada: Kannada

kayah-li: Kayah li

kazakh: Cazaque

kharoshthi: Kharoshthi

khmer: Khmer

khojki: Khojki

khudawadi: Khudawadi

lao: Laosiano

latin: Latino

lepcha: Lepcha

limbu: Limbu

linear-b-Syllabary: Silabário linear B

lisu: Lisu

lycian: Liceu

lydian: Lídiano

nabataean: Nabateano

mahajani: Mahajani

malayalam: Malayalam

mandaic: Mandaico

manichaean: Maniqueísta

meetei-mayek: Meetei mayek

mende-kikakui: Menkikakui

meroitic-cursive: Meroítico cursivo

modi: Modi

mongolian: Mongol

mro: Mro

myanmar: Myanmar

new-tai-lue: Tai lue novo

nko: Nko

ogham: Ngham

ol-chiki: Ol chiki

old-italic: Etrusco itálico antigo

old-north-arabian: Arabe norte antigo

old-permic: Permic antigo

old-persian: Persa antigo

old-south-arabian: Arabe sul antigo

old-turkic: Turkic rúnico antigo

oriya: Oriya

osmanya: Osmanya

pahawh-hmong: Pahawh hmong

pahlavi: Pahlavi

palmyrene: Palmyrene

pau-cin-hau: Pau cin hau

phags-pa: Phags-pa

phoenician: Fenício

polish: Polonês

pollard: Pollard

rejang: Rejang

runic: Rúnico

russian: Russo

samaritan: Samaritano

saurashtra: Saurashtra

sharada: Sharada

shavian: Shaviano

siddham: Siddham

sinhala: Cingalês

sora-sompeng: Sora sompeng

spanish: Espanhol

sundanese: Sundanês

swedish: Sueco

syloti-nagri: Syloti nagri

syriac: Sírio

tagalog: Tagalo

tagbanwa: Tagbanwa

tai-le: Tai

tai-tham: Tai tham

tai-viet: Tai viet

takri: Takri

tamil: Tâmil

tatar: Tártaro

telugu: Telugu

thaana: Thaana

thai: Tailandês

tibetan: Tibetano

tifinagh: Tifinagh

tirhuta: Tirhuta

turkish: Turco

ugaritic: Ugarítico

ukrainian: Ucraniano

unified-canadian-aboriginal-syllabics: Canadense indígena unificado silabario

vai: Silabário

varang-kshiti: Varang kshiti

yi-syllables: Yi silabário
