arab : 아랍어

armenian : 아르메니아

avestan : 아베스탄

balinese : 발리의

bamum : 바움

bashkir : 바시 키르

bassa-vah : 밧 바

batak : 바 정력

belarusian : 벨로루시 어

bengali : 벵골어

bopomofo : 주음 자모 (주음 부호)

brahmi : 브라 미미

buginese : 부기

buhid : 부 히드 문자

bulgarian : 불가리아

carian : 카리안

caucasian-albanian : 코카서스 알바니아

chakma : 차 곰

cham : 참

cherokee : 체로키

chinese : 중국어 병음

coptic : 코프 틱

cypriot-syllabary : 키프로스 음절

cyrillic : 키릴 문자

czech : 체코 어

deseret : Deseret

devanagari : 드 파나 갈리

elbasan : 엘바 산의

english : 영어

esperanto : 에스페란토 문자

ethiopic : 에티오피아 Ge'ez

french : 프랑스어

georgian : 조지아의

german : 독일어

glagolitic : 그라 가릿토

gothic : 고딕

grantha : 그란 지원

greek : 그리스어

gujarati : 구자라트 어

gurmukhi : 그룸 키

hangul : 한글

hanunoo : 하누 누

hebrew : 히브리 문자

hungarian : 헝가리어

imperial-aramaic : 황제 아람어

international-phonetic-alphabet : 국제 발음 기호

italian : 이탈리아어

japanese-hiragana : 일본어 히라가나

japanese-katakana : 일본어 카타카나

javanese : 자바

kaithi : 카이 티

kannada : 칸나 다

kayah-li : 카야 리 문자

kazakh : 카자흐어

kharoshthi : 카로 시티

khmer : 크메르

khojki : 거지

khudawadi : 쿠다 와디

lao : 라오 어

latin : 라틴

lepcha : Lepcha

limbu : 림 흔들림

linear-b-Syllabary : 리니어 B 음절

lisu : Lisu

lycian : 리 시안

lydian : 리디아 바겐

nabataean : 나 바타리안

mahajani : 마하 자니

malayalam : 말라 얄

mandaic : 만다

manichaean : 마니카이아

meetei-mayek : 마니뿌리 문자

mende-kikakui : 남자 데키 여러분

meroitic-cursive : 메로에이토 필기체

modi : 모디

mongolian : 몽골

mro : 모로코

myanmar : 미얀마

new-tai-lue : 새로운 타이

nko : 징코

ogham : 나 껌

ol-chiki : 올 치키

old-italic : 오래된 기울임 에트루리아

old-north-arabian : 구 북부

old-permic : 오래된 permic

old-persian : 구 페르시아어

old-south-arabian : 오래된 남쪽 아라비아 인의

old-turkic : 고대 터키어

oriya : 오 리어

osmanya : 오스만 야

pahawh-hmong : 빠하우아

pahlavi : 팔레 루비

palmyrene : 팔미 진

pau-cin-hau : 포 싱 뉴

phags-pa : Phags-pa

phoenician : 훼니시아

polish : 폴란드

pollard : 폴란드

rejang : 레 장

runic : 르 닉

russian : 러시아 문자

samaritan : 사마리아의

saurashtra : 사라 슈트라

sharada : 샤라 다

shavian : 샤 비안

siddham : 시드 햄

sinhala : 싱 할라

sora-sompeng : 소라 · 문뻰구

spanish : 스페인어

sundanese : 다어

swedish: 스웨덴어

syloti-nagri : 시로티 · 구타 문자

syriac : 시리아

tagalog : 타갈로그어

tagbanwa : 타구바누아

tai-le : 태국

tai-tham : 북의

tai-viet : 타이 베이트

takri : 타쿠리

tamil : 타밀어

tatar : 타타르

telugu : 텔루구 어

thaana : 데이터 함정

thai : 타이

tibetan : 티베트의

tifinagh : 티후나구 문자

tirhuta : 티르

turkish : 터키어

ugaritic : 우가니아

ukrainian : 우크라이나어

unified-canadian-aboriginal-syllabics : 통일 된 캐나다 출신의 음절

vai : 가나다

varang-kshiti : 바 순위 시티

yi-syllables : 이 문자 (이 문자) 
