properties: Propriedades
hide: Esconder
show: Mostrar
up: Acima
range: Intervalo
loading: Carregando, por favor espere...
count: NÃºmero de caracteres
sort-order: Por ordem
sort-block: Por blocos
copy-clipboard: Copiar para Ã¡rea de transferÃªncia
help-range: Clique para destacar o intervalo
more: Mais
prev: Anterior
next: PrÃ³ximo
separate-page: Abrir em pÃ¡gina separada
share-link: Compartilhe com amigos
recent: Recente
recent-text: Here will display recently used symbols. So far, see the popular symbols
read-more: Consulte Mais informaÃ§Ã£o
read-less: ocultar
madeby: Feito por
keepupdates: Siga-nos
hint: Selecione e copie o caractere que vocÃª precisa

copied: Copiado!
see_also: Ver tambÃ©m
page_content_menu: SumÃ¡rio
homepage: Pagina inicial
cookie-message: Este site usa ğŸªcookie para garantir que vocÃª obtenha a melhor experiÃªncia.
accept: Aceitar
empty-cell: CÃ©lula vazia
block-description: DescriÃ§Ã£o
more-information: Consulte Mais informaÃ§Ã£o
back: AtrÃ¡s
widget-keyboard-title: Ãrea de transferÃªncia de sÃ­mbolos
widget-keyboard-placeholder: Aqui estÃ£o todos os sÃ­mbolos que vocÃª copia âœ¨

[mobile]
to-full: Ir para a versÃ£o completa
to-mobile: VersÃ£o mÃ³vel

[edit]: Editar
save: Salvar
submit: Enviar
undo: Desfazer
send-changes: Suas alteraÃ§Ãµes serÃ£o enviadas para os desenvolvedores do site. VocÃª tem certeza?
thanks: Obrigado!
