arab: Arab

armenian: Armenesc

avestan: Avestică

balinese: Balinic

bamum: Bamum

bashkir: Bașchiră

bassa-vah: Bassa-vah

batak: Batak

belarusian: Belarus

bengali: Bengal

bopomofo: Bopomofo. Zhuyin

brahmi: Brahmi

buginese: Buginese

buhid: Buhid

bulgarian: Bulgar

carian: Carabine

caucasian-albanian: Caucazian albanez

chakma: Chakma

cham: Cham

cherokee: Cherokee

chinese: Chinese Pinyin

coptic: Coptic

cypriot-syllabary: Cipriot syllabar

cyrillic: Chirilic

czech: Ceh

deseret: Deseuri

devanagari: Devanagari

elbasan: Elbasan

english: Engleze

esperanto: Esperanto
	
ethiopic: Ethiopic Ge'ez
	
french: Francez
	
georgian: Georgian
	
german: German
	
glagolitic: Glagolitic
	
gothic: Gothic
	
grantha: Grantha
	
greek: Grecesc
	
gujarati: Gujarati
	
gurmukhi: Gurmukhi
	
hangul: Hangulul
	
hanunoo: Hanunoo
	
hebrew: Ebraic
	
hungarian: Maghiară
	
imperial-aramaic: Imperial aramaic
	
international-phonetic-alphabet: Internațional fonetic
	
italian: Italiană
	
japanese-hiragana: Hiragana japonez
	
japanese-katakana: Japoneză catakana
	
javanese: Javanese
	
kaithi: Kaithi
	
kannada: Kannada
	
kayah-li: Kayah li
	
kazakh: Kazah
	
kharoshthi: Kharoshthi
	
khmer: Khmer
	
khojki: Khojki
	
khudawadi: Khudawadi
	
lao: Lao
	
latin: Latin
	
lepcha: Lepcha
	
limbu: Limba
	
linear-b-Syllabary: Linear B syllabary
	
lisu: Lisu
	
lycian: Lycian
	
lydian: Lydian
	
nabataean: Nabataean
	
mahajani: Mahajani
	
malayalam: Malayalam
	
mandaic: Mandaic
	
manichaean: Manichaean
	
meetei-mayek: Metetei Mayek
	
mende-kikakui: Mende kikakui
	
meroitic-cursive: Mercitic cursiv
	
modi: Modi
	
mongolian: Mongolă
	
mro: Mro
	
myanmar: Myanmar
	
new-tai-lue: Noua tai lue
	
nko: Nko
	
ogham: Ngham
	
ol-chiki: Ol Chiki
	
old-italic: Etrusc al italicului italian 
	
old-north-arabian: Vechiul din Arabia de Nord
	
old-permic: Vechiul permic
	
old-persian: Vechiul persan
	
old-south-arabian: Sudic din Arabia de Sud
	
old-turkic: Vechiul turcesc turc
	
oriya: Oriya
	
osmanya: Osmanya
	
pahawh-hmong: Pahawh hmong
	
pahlavi: Pahlavi
	
palmyrene: Palmyrene
	
pau-cin-hau: Pau cin hau
	
phags-pa: Fage-pa
	
phoenician: Fenician
	
polish: Polonez
	
pollard: Pollard
	
rejang: Rejang
	
runic: Runică
	
russian: Rusesc
	
samaritan: Samaritanul
	
saurashtra: Saurashtra
	
sharada: Sharada
	
shavian: Shavian
	
siddham: Siddham
	
sinhala: Sinhala
	
sora-sompeng: Sora sompeng
	
spanish: Spaniol
	
sundanese: Sundanese

swedish: Suedeză
	
syloti-nagri: Syloti nagri
	
syriac: Siriac
	
tagalog: Tagalog
	
tagbanwa: Tagbanwa
	
tai-le: Tai-le
	
tai-tham: Tai-tham
	
tai-viet: Tai-viet
	
takri: Takri
	
tamil: Tamil
	
tatar: Tatar
	
telugu: Telugu
	
thaana: Thaana
	
thai: Thai
	
tibetan: Tibetan
	
tifinagh: Tifinagh
	
tirhuta: Tirhuta
	
turkish: Turc
	
ugaritic: Ugaritic
	
ukrainian: Ucrainean
	
unified-canadian-aboriginal-syllabics: Unitatea abilitară canadiană unificată
	
vai: Syllabarul Vai
	
varang-kshiti: Varang kshiti
	
yi-syllables: Syllabarul Yi
