arab: อาหรับ

armenian: อาร์มีเนีย

avestan: อเวสตะ

balinese: บาหลี

bamum: Bamum

bashkir: ภาษาแบชเคียร์

bassa-vah: Bassa-vah

batak: บาตัก

belarusian: เบลารุส

bengali: เบงกาลี

bopomofo: Bopomofo จู้อิน

brahmi: พราหมี

buginese: Buginese

buhid: Buhid

bulgarian: บัลแกเรีย

carian: คาเรีย

caucasian-albanian: คอเคเชี่ยนแอลเบเนีย

chakma: จักรี

cham: จาม

cherokee: เชอโรกี

chinese: พินอิน

coptic: คอปติก

cypriot-syllabary: ไซปรัส

cyrillic: ซีริลลิก

czech: เช็ก

deseret: Deseret

devanagari: เทวนาครี

elbasan: เอลบาซาน

english: ภาษาอังกฤษ

esperanto: ภาษาเอสเปรันโต
	
ethiopic: Ethiopic Geʻez
	
french: ภาษาฝรั่งเศส
	
georgian: จอร์เจีย
	
german: ภาษาเยอรมัน
	
glagolitic: Glagolitic
	
gothic: กอธิค
	
grantha: Grantha
	
greek: กรีก
	
gujarati: คุชราต
	
gurmukhi: Gurmukhi
	
hangul: อังกูล
	
hanunoo: Hanunoo
	
hebrew: ฮีบรู
	
hungarian: ฮังการี
	
imperial-aramaic: อราเมอิกอิมพีเรียล
	
international-phonetic-alphabet: สัทอักษรสากล
	
italian: อิตาลี
	
japanese-hiragana: ฮิระงะนะญี่ปุ่น
	
japanese-katakana: คาตาคานะญี่ปุ่น
	
javanese: ชวา
	
kaithi: Kaithi
	
kannada: กั ณ ณาท
	
kayah-li: Kayah li
	
kazakh: คาซัค
	
kharoshthi: คาโรห์ธิ
	
khmer: เขมร
	
khojki: Khojki
	
khudawadi: Khudawadi
	
lao: ลาว
	
latin: ละติน
	
lepcha: Lepcha
	
limbu: ลิมบู
	
linear-b-Syllabary: พยางค์ B เชิงเส้น
	
lisu: ลีซอ
	
lycian: Lycian
	
lydian: Lydian
	
nabataean: Nabataean
	
mahajani: Mahajani
	
malayalam: มาลายาลัม
	
mandaic: Mandaic
	
manichaean: Manichaean
	
meetei-mayek: Meetei mayek
	
mende-kikakui: Mende kikakui
	
meroitic-cursive: ตัวสะกด Meroitic
	
modi: Modi
	
mongolian: มองโกเลีย
	
mro: Mro
	
myanmar: พม่า
	
new-tai-lue: ไทลื้อใหม่
	
nko: Nko
	
ogham: พยัญชนะไทย
	
ol-chiki: Ol chiki
	
old-italic: อิทรัสตัวเอียงเก่า
	
old-north-arabian: ภาษาอาหรับทิศตะวันตกเฉียงเหนือเก่า
	
old-permic: Permic เก่า
	
old-persian: เปอร์เซียโบราณ
	
old-south-arabian: อารเบียใต้เก่า
	
old-turkic: รูนโบราณของตุรกี
	
oriya: โอริยา
	
osmanya: ออสมันยา
	
pahawh-hmong: ม้งปะหัง
	
pahlavi: ปาห์ลาวี
	
palmyrene: Palmyrene
	
pau-cin-hau: Pau cin hau
	
phags-pa: Phags-pa
	
phoenician: ภาษาฟินีเซียน
	
polish: โปแลนด์
	
pollard: Pollard
	
rejang: Rejang
	
runic: รูน
	
russian: รัสเซีย
	
samaritan: พลเมือง
	
saurashtra: Saurashtra
	
sharada: Sharada
	
shavian: Shavian
	
siddham: Siddham
	
sinhala: สิงหล
	
sora-sompeng: โซระสมเพ็ง
	
spanish: สเปน
	
sundanese: ซุนดา

swedish: สวีเดน
	
syloti-nagri: Syloti nagri
	
syriac: Syriac
	
tagalog: ภาษาตากาล็อก
	
tagbanwa: Tagbanwa
	
tai-le:ไทเลอ
	
tai-tham:ไทแทม
	
tai-viet:เวียดนาม
	
takri:ตะกรี
	
tamil:ทมิฬ
	
tatar:ตาตาร์
	
telugu:เตลูกู
	
thaana:ไทย
	
thai:ไทย
	
tibetan:ทิเบต
	
tifinagh: Tifinagh
	
tirhuta: Tirhuta
	
turkish:ตุรกี
	
ugaritic: Ugaritic
	
ukrainian:ยูเครน
	
unified-canadian-aboriginal-syllabics: พยางค์ดั้งเดิมของแคนาดาเป็นปึกแผ่น
	
vai: พยางค์ Vai
	
varang-kshiti: Varang kshiti
	
yi-syllables: ยี่พยางค์
