properties: ProprietÄƒÈ›i
hide: Ascunde
show: Spectacol
up: Sus
range: Interval
loading: Se Ã®ncarcÄƒ, te rugÄƒm sÄƒ aÈ™tepÈ›i...
count: NumÄƒr de caractere
sort-order: DupÄƒ ordine
sort-block: DupÄƒ blocuri
copy-clipboard: CopiazÄƒ Ã®n clipboard
help-range: Click pentru marcare interval
more: Mai mult
prev: Ãnapoi
next: Ãnainte
separate-page: Deschide Ã®n paginÄƒ separatÄƒ
share-link: Distribuie prietenilor
recent: Recent
recent-text: Aici se afiÈ™eazÄƒ simbolurile utilizate recent. Vezi simbolurile populare.
read-more: Vezi mai mult
read-less: Ascunde

copied: Copiat!
see_also: Vezi si
page_content_menu: ConÈ›inutul
homepage: Pagina principala
cookie-message: Acest site utilizeazÄƒ ğŸªcookie-uri pentru a vÄƒ asigura cÄƒ veÈ›i obÈ›ine cea mai bunÄƒ experienÈ›Äƒ.
accept: Accept
empty-cell: Celula goalÄƒ
block-description: Descriere
more-information: Citeste mai mult
back: Ãnapoi
widget-keyboard-title: Clipboard pentru simboluri
widget-keyboard-placeholder: Aici sunt toate simbolurile pe care le copiaÈ›i âœ¨

[mobile]
to-full: Mergi la versiunea completÄƒ
to-mobile: Versiune mobilÄƒ

[edit]: Modificare
save: SalveazÄƒ
submit: Trimite
undo: AnuleazÄƒ
send-changes: ModificÄƒrile tale vor fi trimise programatorilor website-ului. EÈ™ti sigur?
thanks: MulÈ›umim!
