properties: ì†ì„±
hide: ìˆ¨ê¸°ë‹¤
show: ë³´ì—¬
up: ë§¨ ìœ„ë¡œ
range: ë²”ìœ„
loading: ë¡œë”© ì¤‘, ì ì‹œ ê¸°ë‹¤ë ¤ì£¼ì‹­ì‹œì˜¤
count: ë¬¸ìì˜ ì´ ìˆ˜
sort-order: ìˆœì°¨ì ìœ¼ë¡œ
sort-block: ë¬¸ì ë²”ìœ„ ì„¸ê·¸ë¨¼íŠ¸ë¥¼ ëˆŒëŸ¬
copy-clipboard: í´ë¦½ ë³´ë“œë¡œ ë³µì‚¬
help-range: ë¬¸ìì˜ ë²”ìœ„ë¥¼ í‘œì‹œí•˜ë ¤ë©´ í´ë¦­
more: ë”
prev: ì•ìœ¼ë¡œ
next: ë’¤ë¡œ
separate-page: ìƒˆë¡œìš´ ì˜¤í”ˆ í˜ì´ì§€
share-link: ëª«
recent: ì¶©ì ì„¸
# @todo recent-text
read-more: ìì„¸íˆë³´ê¸°
read-less: ìˆ¨ê¸°ê¸°

copied: ë³µì‚¬ë˜ì—ˆìŠµë‹ˆë‹¤!
see_also: ì°¸ì¡°
page_content_menu: ë‚´ìš©
homepage: í™ˆí˜ì´ì§€
cookie-message: ì´ ì‚¬ì´íŠ¸ëŠ” ìµœê³ ì˜ ê²½í—˜ì„ ë³´ì¥í•˜ê¸° ìœ„í•´ ğŸªì¿ í‚¤ë¥¼ ì‚¬ìš©í•©ë‹ˆë‹¤.
accept: ë™ì˜í•˜ê¸°
empty-cell: ë¹ˆ ì…€
block-description: ì„¤ëª…
more-information: ë” ì½ê¸°
back: ë’¤ìª½ì—
widget-keyboard-title: ì‹¬ë³¼ í´ë¦½ë³´ë“œ
widget-keyboard-placeholder: ì—¬ê¸°ì— ë³µì‚¬í•œ ëª¨ë“  ê¸°í˜¸ê°€ í‘œì‹œë©ë‹ˆë‹¤ âœ¨

[mobile]
to-full: ì •ì‹ ë²„ì „ìœ¼ë¡œ ì´ë™
to-mobile: ëª¨ë°”ì¼ ë²„ì „

[edit]: í¸ì§‘
save: ì €ì¥
submit: ì œì¶œ
undo: ì·¨ì†Œ
send-changes: ë³€ê²½ ì‚¬í•­ì€ ì‚¬ì´íŠ¸ì˜ ê°œë°œë¡œ ì „ì†¡ë©ë‹ˆë‹¤. ë‹¹ì‹ ì€ í™•ì‹¤í•œê°€ìš”?
thanks: ê³ ë§™ìŠµë‹ˆë‹¤

