arab: Arabe

armenian: Arménien

avestan: Avestan

balinese: Balinaise

bamum: Bamoun

bashkir: Bachkir

bassa-vah: Bassa-vah

batak: Batak

belarusian: Biélorusse

bengali: Bengali

bopomofo: Bopomofo. Zhuyin

brahmi: Brahmi

buginese: Buginais

buhid: Buhid

bulgarian: Bulgare

carian: Cariens

caucasian-albanian: Caucasien albanais

chakma: Changma

cham: Cham

cherokee: Cherokee

chinese: Chinois pinyin

coptic: Copte

cypriot-syllabary: Chypriote Syllabaire

cyrillic: Cyrillique

czech: Tchèque

deseret: Déséret

devanagari: Devanagari

elbasan: Elbasan

english: Anglais

esperanto: Espéranto
	
ethiopic: Ethiopique
	
french: Francais
	
georgian: Géorgien
	
german: Allemand
	
glagolitic: Glagolitique
	
gothic: Gothique
	
grantha: Grantha
	
greek: Grec
	
gujarati: Gujarati
	
gurmukhi: Gurmukhi
	
hangul: Hangul
	
hanunoo: Hanunoo
	
hebrew: Hébreu
	
hungarian: Hongrois
	
imperial-aramaic: Araméen impérial
	
international-phonetic-alphabet: Phonétique international
	
italian: Italien
	
japanese-hiragana: Japonais en hiragana
	
japanese-katakana: Japonais de katakana
	
javanese: Javanais
	
kaithi: Kaithi
	
kannada: Kannada
	
kayah-li: Kayah li
	
kazakh: Kazakh
	
kharoshthi: Kharoshthi
	
khmer: Khmer
	
khojki: Khojki
	
khudawadi: Khudawadi
	
lao: Lao
	
latin: Latin
	
lepcha: Lepcha
	
limbu: Limbu
	
linear-b-Syllabary: Syllabaire linéaire B
	
lisu: Lisu
	
lycian: Lycien
	
lydian: Lydien
	
nabataean: Nabatéen
	
mahajani: Mahajani
	
malayalam: Malayalam
	
mandaic: Mandaic
	
manichaean: Manichéen
	
meetei-mayek: Meetei Mayek
	
mende-kikakui: Mende kikakui
	
meroitic-cursive: méroïtique cursif
	
modi: Modi
	
mongolian: Mongol
	
mro: Mro
	
myanmar: Myanmar
	
new-tai-lue: Tai Lue nouvel
	
nko: Nko
	
ogham: Ngham
	
ol-chiki: Ol chiki
	
old-italic: Etrusque italique ancien
	
old-north-arabian: Nord-arabe ancien
	
old-permic: Permic ancien
	
old-persian: Persan ancien
	
old-south-arabian: Du sud de l'arabe ancien
	
old-turkic: Runique turc ancien
	
oriya: Oriya
	
osmanya: Osmanya
	
pahawh-hmong: Pahawh hmong
	
pahlavi: Pahlavi
	
palmyrene: Palmyrene
	
pau-cin-hau: Pau cin hau
	
phags-pa: Phags-pa
	
phoenician: Phénicien
	
polish: Polonais
	
pollard: Pollard
	
rejang: Rejang
	
runic: Runique
	
russian: Russe
	
samaritan: Samaritain
	
saurashtra: Saurashtra
	
sharada: Sharada
	
shavian: Shavian
	
siddham: Siddham
	
sinhala: Cinghalais
	
sora-sompeng: Sora sompeng
	
spanish: Espagnol
	
sundanese: Sundanese

swedish: Suédois
	
syloti-nagri: Syloti Nagri
	
syriac: Syriaque
	
tagalog: Tagalog
	
tagbanwa: Tagbanwa
	
tai-le: Tai le
	
tai-tham: Tai Tham
	
tai-viet: Tai viet
	
takri: Takri
	
tamil: Tamoul
	
tatar: Tatar
	
telugu: Telugu
	
thaana: Thaana
	
thai: Thaï
	
tibetan: Tibétain
	
tifinagh: Tifinagh
	
tirhuta: Tirhuta
	
turkish: Turc
	
ugaritic: Ougaritique
	
ukrainian: Ukrainien
	
unified-canadian-aboriginal-syllabics: Canadien aborigène unifié syllabaire
	
vai: Vai syllabaire 
	
varang-kshiti: Varang kshiti
	
yi-syllables: Yi syllabaire
