properties: Ã–zellikler
hide: Sakla
show: GÃ¶steri
up: Up
range: AralÄ±k
loading: YÃ¼kleniyor lÃ¼tfen bekleyin...
count: Karakter sayÄ±sÄ±
sort-order: Emriyle
sort-block: Bloklarla
copy-clipboard: Panoya kopyala
help-range: Menzilini vurgulamak iÃ§in tÄ±klayÄ±n
more: Daha
prev: Ã–nceki
next: Sonraki
separate-page: AyrÄ± sayfada aÃ§
share-link: ArkadaÅŸlarÄ±nla paylaÅŸ
recent: Son
recent-text: Burada son zamanlarda kullanÄ±lan simgeler gÃ¶rÃ¼ntÃ¼lenecektir. Åimdiye kadar popÃ¼ler simgelere bakÄ±n
read-more: Daha fazla oku
read-less: Saklamak
madeby: TarafÄ±ndan Ã¼retildi
keepupdates: Bizi takip et
hint: Ä°htiyacÄ±nÄ±z olan karakteri seÃ§in ve kopyalayÄ±n

copied: KopyalandÄ±!
see_also: AyrÄ±ca bakÄ±nÄ±z
page_content_menu: IÃ§erik
homepage: Anasayfa
cookie-message: Bu site en iyi deneyimi yaÅŸamanÄ±zÄ± saÄŸlamak iÃ§in ğŸªÃ§erezleri kullanÄ±r.
accept: Kabul etmek
empty-cell: BoÅŸ hÃ¼cre
block-description: TanÄ±m
more-information: Daha fazla oku
back: Geri

[mobile]
to-full: Tam sÃ¼rÃ¼me git
to-mobile: Mobil versiyon

[edit]: DÃ¼zenle
save: KayÄ±t etmek
submit: GÃ¶nder
undo: Geri alma
send-changes: DeÄŸiÅŸiklikleriniz web sitesi geliÅŸtiricilerine gÃ¶nderilecek. Emin misiniz?
thanks: TeÅŸekkÃ¼rler!

