arab: Арабский
armenian: Армянский
avestan: Авестийский
balinese: Балийский
bamum: Бамум (а-ка-у-ку)
bashkir: Башкирский
bassa-vah: Басса
batak: Батакский
belarusian: Белорусский
bengali: Бенгальский
bopomofo: Бопомофо (чжуинь фухао)
brahmi: Брахми
buginese: Бугийский (лонтара)
buhid: Бухид
bulgarian: Болгарский
carian: Карийский
caucasian-albanian: Агванский
chakma: Чакма
cham: Чамский
cherokee: Чероки
chinese: Пиньинь (китайский)
coptic: Коптский
cypriot-syllabary: Кипрский
cyrillic: Кириллица
czech: Чешский
deseret: Дезеретский
devanagari: Деванагари
elbasan: Эльбасанский
english: Английский
esperanto: Эсперанто
ethiopic: Эфиопский
french: Французский
georgian: Грузинский
german: Немецкий
glagolitic: Глаголица
gothic: Готский
grantha: Грантха
greek: Греческий
gujarati: Гуджарати
gurmukhi: Гурмукхи
hangul: Хангыль (корейский)
hanunoo: Хануноо
hebrew: Еврейский
hungarian: Венгерский
imperial-aramaic: Арамейский имперский
international-phonetic-alphabet: Международный фонетический
italian: Итальянский
japanese-hiragana: Хирагана (японский)
japanese-katakana: Катакана (японский)
javanese: Яванский
kaithi: Кайтхи
kannada: Каннада
kayah-li: Кайях Ли
kazakh: Казахский
kharoshthi: Кхароштхи
khmer: Кхмерский
khojki: Кходжики
khudawadi: Кхудабади
lao: Лаосский
latin: Латинский
lepcha: Лепча
limbu: Лимбу
linear-b-Syllabary: Линейное письмо Б
lisu: Лису
lycian: Ликийский
lydian: Лидийский
mahajani: Махаджани
malayalam: Малаялам
mandaic: Мандейский
manichaean: Манихейский
meetei-mayek: Манипури (мейтей-маек)
mende-kikakui: Кикакуи
meroitic-cursive: Мероитский курсивный
modi: Моди
mongolian: Монгольский старый
mro: Мру
myanmar: Бирманский
nabataean: Набатейский
new-tai-lue: Новый Лы (тай-лы)
nko: Нко 
ogham: Огамический
ol-chiki: Ол-чики
old-italic: Этрусский
old-north-arabian: Аравийские северные старые
old-permic: Пермский древний
old-persian: Персидский древний клинописный
old-south-arabian: Аравийский южный
old-turkic: Тюркский древний рунический
oriya: Ория
osmanya: Сомалийский (османья)
pahawh-hmong: Пахау
pahlavi: Пехлеви
palmyrene: Пальмирский
pau-cin-hau: Пау Цин Хау
phags-pa: Пагба-ламы
phoenician: Финикийский
polish: Польский
pollard: Полларда
rejang: Реджангский
runic: Германский рунический
russian: Русский
samaritan: Самаритянский
saurashtra: Саураштра
sharada: Шарада
shavian: Бернарда Шоу
siddham: Сиддхаматрики
sinhala: Сингальский
sora-sompeng: Соранг-сомпенг
spanish: Испанский
sundanese: Сунданский
swedish: Шведский
syloti-nagri: Силхети нагари
syriac: Сирийский
tagalog: Тагальский
tagbanwa: Тагбанва
tai-le: Лы (тай-лы)
tai-tham: Ланна (тай-тхам)
tai-viet: Тай-вьет
takri: Такри
tamil: Тамильский
tatar: Татарский
telugu: Телугу
thaana: Тана
thai: Тайский
tibetan: Тибетский
tifinagh: Тифанаг
tirhuta: Тирхута
turkish: Турецкий
ugaritic: Угаритский
ukrainian: Украинский
unified-canadian-aboriginal-syllabics: Канадских аборигенов слоговый
vai: Ваи слоговый 
varang-kshiti: Варанг-кшити
yi-syllables: Йи слоговый 
