arab: Árabe 

armenian: Armenio 

avestan: Avestano

balinese: Balinés

bamum: Bamum

bashkir: Baskir

bassa-vah: Bassa-vah

batak: Batak

belarusian: Bielorruso

bengali: Bengalí

bopomofo: Bopomofo. Zhuyin

brahmi: Brahmi

buginese: Bugino

buhid: Buhid

bulgarian: Búlgaro

carian: Cario

caucasian-albanian: Albanés Caucásico

chakma: Chakma

cham: Cham

cherokee: Cherokee

chinese: Chino Pinyin 

coptic: Copto

cypriot-syllabary: Chiprioto Silabario 

cyrillic: Cirílico

czech: Checo

deseret: Deseret

devanagari: Devanagari

elbasan: Elbasan

english: Inglés

esperanto: Esperanto
	
ethiopic: Geʻez Etíope
	
french: Francés
	
georgian: Georgiano
	
german: Aleman
	
glagolitic: Glagolitico
	
gothic: Gótico
	
grantha: Grantha
	
greek: Griego
	
gujarati: Gujarati
	
gurmukhi: Gurmukhi
	
hangul: Hangul
	
hanunoo: Hanunoo
	
hebrew: Hebreo
	
hungarian: Húngaro
	
imperial-aramaic: Arameo Imperial
	
international-phonetic-alphabet: Fonético Internacional
	
italian: Italiano
	
japanese-hiragana: Hiragana Japonés
	
japanese-katakana: Japonés Katakana
	
javanese: Javanés
	
kaithi: Kaithi
	
kannada: Kannada
	
kayah-li: Kayah Li 
	
kazakh: Kazajo
	
kharoshthi: Kharoshthi
	
khmer: Khmer
	
khojki: Khojki
	
khudawadi: Khudawadi
	
lao: Lao
	
latin: Latino
	
lepcha: Lepcha
	
limbu: Limbu
	
linear-b-Syllabary: Lineal B Silabario 
	
lisu: Lisu
	
lycian: Liciano
	
lydian: Lidia
	
nabataean: Nabateo
	
mahajani: Mahajani
	
malayalam: Malayalam
	
mandaic: Mandaico
	
manichaean: Maniquea
	
meetei-mayek: Meetei Mayek 
	
mende-kikakui: Mende Kikakui
	
meroitic-cursive: Meroitico Cursivo
	
modi: Modi
	
mongolian: Mongol
	
mro: Mro
	
myanmar: Myanmar
	
new-tai-lue: Nuevo Tai Lue
	
nko: Nko
	
ogham: Ogham
	
ol-chiki: Ol Chiki
	
old-italic: Etrusco Antiguo Cursivo 
	
old-north-arabian: Arabe de Norte Antiguo
	
old-permic: Permico Antiguo
	
old-persian: Perso Antiguo
	
old-south-arabian: Árabe de Sur Antiguo
	
old-turkic: Turco Rúnico Antiguo
	
oriya: Oriya
	
osmanya: Osmanya
	
pahawh-hmong: Pahawh Hmong 
	
pahlavi: Pahlavi
	
palmyrene: Palmyrene
	
pau-cin-hau: Pau Cin Hau
	
phags-pa: Phags-pa
	
phoenician: Fenicio
	
polish: Polaco
	
pollard: Pollard
	
rejang: Rejang
	
runic: Rúnico
	
russian: Ruso
	
samaritan: Samaritano
	
saurashtra: Saurashtra
	
sharada: Sharada
	
shavian: Shavian
	
siddham: Siddham
	
sinhala: Sinhala
	
sora-sompeng: Sora Sompeng 
	
spanish: Español
	
sundanese: Sundanés

swedish: Sueco
	
syloti-nagri: Syloti Nagri 
	
syriac: Siríaco
	
tagalog: Tagalo
	
tagbanwa: Tagbanwa
	
tai-le: Tai Le
	
tai-tham: Tai Tham
	
tai-viet: Tai Vietnam
	
takri: Takri
	
tamil: Tamil
	
tatar: Tártaro
	
telugu: Telugu
	
thaana: Thaana
	
thai: Tailandés
	
tibetan: Tibetano
	
tifinagh: Tifinagh
	
tirhuta: Tirhuta
	
turkish: Turco
	
ugaritic: Ugaritico
	
ukrainian: Ucraniano
	
unified-canadian-aboriginal-syllabics: Silabario Aborigen Canadiense Unificado
	
vai: Silabario Vai
	
varang-kshiti: Varang Kshiti
	
yi-syllables: Yi Silabario 
